GEOID,totalUnits,occupiedUnits,vacantUnits,whiteHouseholds,renterOccupied,vacancyShare,whiteShare,renterShare,name
060750314005,407,383,24,88,106,0.05896805896805897,0.2297650130548303,0.27676240208877284,"Block Group 5,  Census Tract 314"
060750326011,667,611,56,311,434,0.08395802098950525,0.5090016366612111,0.7103109656301145,"Block Group 1,  Census Tract 326.01"
060750326012,576,546,30,240,373,0.052083333333333336,0.43956043956043955,0.6831501831501832,"Block Group 2,  Census Tract 326.01"
060750326013,602,571,31,251,329,0.05149501661129568,0.4395796847635727,0.5761821366024519,"Block Group 3,  Census Tract 326.01"
060750326021,709,673,36,286,312,0.05077574047954866,0.424962852897474,0.4635958395245171,"Block Group 1,  Census Tract 326.02"
060750326022,497,484,13,225,244,0.026156941649899398,0.46487603305785125,0.5041322314049587,"Block Group 2,  Census Tract 326.02"
060750326023,537,512,25,254,276,0.04655493482309125,0.49609375,0.5390625,"Block Group 3,  Census Tract 326.02"
060750327002,507,474,33,229,263,0.0650887573964497,0.4831223628691983,0.5548523206751055,"Block Group 2,  Census Tract 327"
060750327004,327,315,12,138,83,0.03669724770642202,0.4380952380952381,0.2634920634920635,"Block Group 4,  Census Tract 327"
060750328012,538,497,41,244,304,0.0762081784386617,0.4909456740442656,0.6116700201207244,"Block Group 2,  Census Tract 328.01"
060750328022,533,499,34,197,216,0.06378986866791744,0.39478957915831664,0.43286573146292584,"Block Group 2,  Census Tract 328.02"
060750329012,450,423,27,183,115,0.06,0.4326241134751773,0.2718676122931442,"Block Group 2,  Census Tract 329.01"
060750329021,442,421,21,162,133,0.04751131221719457,0.3847980997624703,0.3159144893111639,"Block Group 1,  Census Tract 329.02"
060750330002,405,387,18,193,134,0.044444444444444446,0.49870801033591733,0.3462532299741602,"Block Group 2,  Census Tract 330"
060750331002,393,377,16,188,55,0.04071246819338423,0.4986737400530504,0.14588859416445624,"Block Group 2,  Census Tract 331"
060750332032,606,568,38,330,567,0.0627062706270627,0.5809859154929577,0.9982394366197183,"Block Group 2,  Census Tract 332.03"
060750332042,685,630,55,347,630,0.08029197080291971,0.5507936507936508,1,"Block Group 2,  Census Tract 332.04"
060750351002,489,453,36,214,260,0.0736196319018405,0.47240618101545256,0.5739514348785872,"Block Group 2,  Census Tract 351"
060750351006,348,330,18,123,106,0.05172413793103448,0.37272727272727274,0.3212121212121212,"Block Group 6,  Census Tract 351"
060750352011,383,364,19,134,140,0.04960835509138381,0.36813186813186816,0.38461538461538464,"Block Group 1,  Census Tract 352.01"
060750352014,500,467,33,269,235,0.066,0.576017130620985,0.5032119914346895,"Block Group 4,  Census Tract 352.01"
060750352022,628,581,47,332,413,0.07484076433121019,0.5714285714285714,0.7108433734939759,"Block Group 2,  Census Tract 352.02"
060750353003,373,358,15,139,104,0.040214477211796246,0.388268156424581,0.2905027932960894,"Block Group 3,  Census Tract 353"
060750354001,462,436,26,221,146,0.05627705627705628,0.5068807339449541,0.3348623853211009,"Block Group 1,  Census Tract 354"
060750354005,453,433,20,221,218,0.04415011037527594,0.5103926096997691,0.5034642032332564,"Block Group 5,  Census Tract 354"
060750401004,398,369,29,255,238,0.0728643216080402,0.6910569105691057,0.6449864498644986,"Block Group 4,  Census Tract 401"
060750402003,615,554,61,294,409,0.0991869918699187,0.5306859205776173,0.7382671480144405,"Block Group 3,  Census Tract 402"
060750427001,842,770,72,419,570,0.0855106888361045,0.5441558441558442,0.7402597402597403,"Block Group 1,  Census Tract 427"
060750428003,229,219,10,181,41,0.043668122270742356,0.8264840182648402,0.1872146118721461,"Block Group 3,  Census Tract 428"
060750451002,592,548,44,290,337,0.07432432432432433,0.5291970802919708,0.614963503649635,"Block Group 2,  Census Tract 451"
060750452003,428,395,33,236,174,0.07710280373831775,0.5974683544303797,0.44050632911392407,"Block Group 3,  Census Tract 452"
060750476002,560,518,42,229,257,0.075,0.4420849420849421,0.49613899613899615,"Block Group 2,  Census Tract 476"
060750477011,729,674,55,342,475,0.07544581618655692,0.5074183976261127,0.7047477744807121,"Block Group 1,  Census Tract 477.01"
060750477021,467,436,31,183,231,0.06638115631691649,0.4197247706422018,0.5298165137614679,"Block Group 1,  Census Tract 477.02"
060750478011,520,474,46,239,232,0.08846153846153847,0.5042194092827004,0.48945147679324896,"Block Group 1,  Census Tract 478.01"
060750478022,487,464,23,211,268,0.04722792607802875,0.4547413793103448,0.5775862068965517,"Block Group 2,  Census Tract 478.02"
060750479013,634,590,44,306,292,0.0694006309148265,0.5186440677966102,0.49491525423728816,"Block Group 3,  Census Tract 479.01"
060750479015,512,460,52,266,256,0.1015625,0.5782608695652174,0.5565217391304348,"Block Group 5,  Census Tract 479.01"
060750479023,502,470,32,225,263,0.06374501992031872,0.4787234042553192,0.5595744680851064,"Block Group 3,  Census Tract 479.02"
060750605021,261,252,9,21,251,0.034482758620689655,0.08333333333333333,0.996031746031746,"Block Group 1,  Census Tract 605.02"
060750611001,668,618,50,138,586,0.0748502994011976,0.22330097087378642,0.948220064724919,"Block Group 1,  Census Tract 611"
060750612001,450,419,31,69,206,0.06888888888888889,0.16467780429594273,0.4916467780429594,"Block Group 1,  Census Tract 612"
060750614003,540,512,28,410,238,0.05185185185185185,0.80078125,0.46484375,"Block Group 3,  Census Tract 614"
060750615004,1305,1070,235,652,431,0.18007662835249041,0.6093457943925233,0.402803738317757,"Block Group 4,  Census Tract 615.00"
060750102002,1372,1231,141,1082,965,0.10276967930029154,0.8789601949634444,0.7839155158407799,"Block Group 2,  Census Tract 102"
060750103002,621,545,76,326,401,0.12238325281803543,0.5981651376146789,0.7357798165137615,"Block Group 2,  Census Tract 103"
060750104002,921,829,92,614,627,0.0998914223669924,0.7406513872135102,0.7563329312424608,"Block Group 2,  Census Tract 104"
060750105002,1389,1172,217,865,1082,0.156227501799856,0.7380546075085325,0.9232081911262798,"Block Group 2,  Census Tract 105"
060750107001,474,420,54,247,352,0.11392405063291139,0.5880952380952381,0.8380952380952381,"Block Group 1,  Census Tract 107"
060750107004,1004,933,71,82,922,0.07071713147410359,0.08788853161843516,0.9882100750267953,"Block Group 4,  Census Tract 107"
060750108003,1034,925,109,543,815,0.10541586073500966,0.587027027027027,0.8810810810810811,"Block Group 3,  Census Tract 108"
060750110001,540,504,36,313,412,0.06666666666666667,0.621031746031746,0.8174603174603174,"Block Group 1,  Census Tract 110"
060750111001,1295,1209,86,726,1121,0.06640926640926641,0.6004962779156328,0.9272125723738627,"Block Group 1,  Census Tract 111"
060750112002,922,717,205,542,541,0.22234273318872017,0.7559274755927475,0.7545327754532776,"Block Group 2,  Census Tract 112"
060750117001,507,430,77,160,400,0.15187376725838264,0.37209302325581395,0.9302325581395349,"Block Group 1,  Census Tract 117"
060750119011,753,598,155,422,446,0.2058432934926959,0.705685618729097,0.745819397993311,"Block Group 1,  Census Tract 119.01"
060750119022,465,399,66,288,360,0.14193548387096774,0.7218045112781954,0.9022556390977443,"Block Group 2,  Census Tract 119.02"
060750123011,1037,903,134,376,901,0.12921890067502412,0.416389811738649,0.9977851605758582,"Block Group 1,  Census Tract 123.01"
060750123021,1178,1102,76,633,1102,0.06451612903225806,0.574410163339383,1,"Block Group 1,  Census Tract 123.02"
060750124021,488,440,48,217,440,0.09836065573770492,0.49318181818181817,1,"Block Group 1,  Census Tract 124.02"
060750125021,1216,1113,103,344,1110,0.08470394736842106,0.3090745732255166,0.9973045822102425,"Block Group 1,  Census Tract 125.02"
060750125022,1093,921,172,229,920,0.15736505032021958,0.248642779587405,0.998914223669924,"Block Group 2,  Census Tract 125.02"
060750127001,996,909,87,779,631,0.08734939759036145,0.856985698569857,0.6941694169416942,"Block Group 1,  Census Tract 127"
060750128002,427,383,44,360,153,0.10304449648711944,0.9399477806788512,0.39947780678851175,"Block Group 2,  Census Tract 128"
060750129011,829,767,62,624,652,0.07478890229191798,0.8135593220338984,0.8500651890482399,"Block Group 1,  Census Tract 129.01"
060750129022,778,708,70,585,586,0.08997429305912596,0.826271186440678,0.827683615819209,"Block Group 2,  Census Tract 129.02"
060750130002,619,566,53,498,396,0.08562197092084006,0.8798586572438163,0.6996466431095406,"Block Group 2,  Census Tract 130"
060750131012,1542,1407,135,1049,1128,0.08754863813229571,0.7455579246624022,0.8017057569296375,"Block Group 2,  Census Tract 131.01"
060750132001,1505,1314,191,1093,1041,0.12691029900332226,0.8318112633181126,0.7922374429223744,"Block Group 1,  Census Tract 132"
060750133005,360,321,39,274,174,0.10833333333333334,0.8535825545171339,0.5420560747663551,"Block Group 5,  Census Tract 133"
060750152001,1315,1221,94,790,1097,0.0714828897338403,0.647010647010647,0.8984438984438985,"Block Group 1,  Census Tract 152"
060750152002,826,757,69,491,566,0.08353510895883777,0.6486129458388376,0.7476882430647291,"Block Group 2,  Census Tract 152"
060750154001,387,363,24,277,232,0.06201550387596899,0.7630853994490359,0.6391184573002755,"Block Group 1,  Census Tract 154"
060750154004,474,437,37,332,289,0.07805907172995781,0.7597254004576659,0.6613272311212814,"Block Group 4,  Census Tract 154"
060750155003,322,293,29,110,274,0.09006211180124224,0.37542662116040953,0.9351535836177475,"Block Group 3,  Census Tract 155"
060750157001,639,589,50,378,403,0.0782472613458529,0.6417657045840407,0.6842105263157895,"Block Group 1,  Census Tract 157"
060750158011,231,192,39,65,92,0.16883116883116883,0.3385416666666667,0.4791666666666667,"Block Group 1,  Census Tract 158.01"
060750158012,847,798,49,420,556,0.05785123966942149,0.5263157894736842,0.6967418546365914,"Block Group 2,  Census Tract 158.01"
060750158021,711,670,41,498,543,0.057665260196905765,0.7432835820895523,0.8104477611940298,"Block Group 1,  Census Tract 158.02"
060750158022,870,821,49,568,681,0.05632183908045977,0.6918392204628502,0.8294762484774665,"Block Group 2,  Census Tract 158.02"
060750159001,1127,1067,60,525,580,0.05323868677905945,0.49203373945641987,0.5435801312089972,"Block Group 1,  Census Tract 159"
060750159002,1286,1218,68,526,1149,0.05287713841368585,0.4318555008210181,0.9433497536945813,"Block Group 2,  Census Tract 159"
060750160001,1847,1633,214,959,1233,0.11586356253383866,0.5872627066748316,0.7550520514390692,"Block Group 1,  Census Tract 160"
060750161003,622,592,30,167,586,0.04823151125401929,0.28209459459459457,0.9898648648648649,"Block Group 3,  Census Tract 161"
060750162002,700,629,71,445,572,0.10142857142857142,0.7074721780604134,0.9093799682034976,"Block Group 2,  Census Tract 162"
060750163002,604,572,32,374,481,0.052980132450331126,0.6538461538461539,0.8409090909090909,"Block Group 2,  Census Tract 163"
060750165001,725,686,39,489,559,0.05379310344827586,0.7128279883381924,0.814868804664723,"Block Group 1,  Census Tract 165"
060750165004,513,485,28,391,373,0.05458089668615984,0.8061855670103093,0.7690721649484537,"Block Group 4,  Census Tract 165"
060750166004,598,554,44,461,406,0.07357859531772576,0.8321299638989169,0.7328519855595668,"Block Group 4,  Census Tract 166"
060750167004,744,687,57,538,505,0.07661290322580645,0.7831149927219796,0.735080058224163,"Block Group 4,  Census Tract 167"
060750168012,609,570,39,399,449,0.06403940886699508,0.7,0.787719298245614,"Block Group 2,  Census Tract 168.01"
060750170001,536,482,54,431,257,0.10074626865671642,0.8941908713692946,0.533195020746888,"Block Group 1,  Census Tract 170"
060750171012,580,541,39,465,280,0.06724137931034482,0.8595194085027726,0.5175600739371534,"Block Group 2,  Census Tract 171.01"
060750171022,315,303,12,252,154,0.0380952380952381,0.8316831683168316,0.5082508250825083,"Block Group 2,  Census Tract 171.02"
060750176013,2002,1511,491,695,1221,0.24525474525474525,0.4599602911978822,0.8080741230972865,"Block Group 3,  Census Tract 176.01"
060750178011,912,864,48,164,846,0.05263157894736842,0.18981481481481483,0.9791666666666666,"Block Group 1,  Census Tract 178.01"
060750178012,1567,1334,233,483,989,0.14869176770899808,0.3620689655172414,0.7413793103448276,"Block Group 2,  Census Tract 178.01"
060750180001,1124,1048,76,667,628,0.06761565836298933,0.6364503816793893,0.5992366412213741,"Block Group 1,  Census Tract 180"
060750201002,639,553,86,334,498,0.13458528951486698,0.6039783001808319,0.9005424954792043,"Block Group 2,  Census Tract 201"
060750202002,1325,1267,58,837,1049,0.04377358490566038,0.6606156274664562,0.8279400157853196,"Block Group 2,  Census Tract 202"
060750203002,344,319,25,243,198,0.07267441860465117,0.7617554858934169,0.6206896551724138,"Block Group 2,  Census Tract 203"
060750204013,699,652,47,552,349,0.06723891273247497,0.8466257668711656,0.5352760736196319,"Block Group 3,  Census Tract 204.01"
060750205001,426,406,20,329,275,0.046948356807511735,0.8103448275862069,0.6773399014778325,"Block Group 1,  Census Tract 205"
060750206003,506,457,49,392,202,0.09683794466403162,0.8577680525164114,0.4420131291028446,"Block Group 3,  Census Tract 206"
060750208002,677,650,27,388,504,0.03988183161004431,0.5969230769230769,0.7753846153846153,"Block Group 2,  Census Tract 208"
060750209001,697,665,32,404,583,0.04591104734576758,0.6075187969924812,0.8766917293233083,"Block Group 1,  Census Tract 209"
060750210001,500,466,34,366,370,0.068,0.7854077253218884,0.7939914163090128,"Block Group 1,  Census Tract 210"
060750211001,601,541,60,462,275,0.09983361064891846,0.8539741219963032,0.5083179297597042,"Block Group 1,  Census Tract 211"
060750212001,488,455,33,403,220,0.06762295081967214,0.8857142857142857,0.4835164835164835,"Block Group 1,  Census Tract 212"
060750213001,551,508,43,435,267,0.0780399274047187,0.8562992125984252,0.5255905511811023,"Block Group 1,  Census Tract 213"
060750214003,618,566,52,454,327,0.08414239482200647,0.8021201413427562,0.5777385159010601,"Block Group 3,  Census Tract 214"
060750215003,440,419,21,334,274,0.04772727272727273,0.7971360381861575,0.6539379474940334,"Block Group 3,  Census Tract 215"
060750217002,476,464,12,355,134,0.025210084033613446,0.7650862068965517,0.28879310344827586,"Block Group 2,  Census Tract 217"
060750218001,577,536,41,441,249,0.07105719237435008,0.8227611940298507,0.46455223880597013,"Block Group 1,  Census Tract 218"
060750226002,592,483,109,373,214,0.18412162162162163,0.772256728778468,0.44306418219461696,"Block Group 2,  Census Tract 226"
060750227021,537,500,37,413,355,0.06890130353817504,0.826,0.71,"Block Group 1,  Census Tract 227.02"
060750228012,745,691,54,459,398,0.07248322147651007,0.6642547033285094,0.5759768451519537,"Block Group 2,  Census Tract 228.01"
060750228032,444,415,29,279,233,0.06531531531531531,0.672289156626506,0.5614457831325301,"Block Group 2,  Census Tract 228.03"
060750229013,342,327,15,193,278,0.043859649122807015,0.5902140672782875,0.8501529051987767,"Block Group 3,  Census Tract 229.01"
060750229032,350,332,18,209,213,0.05142857142857143,0.6295180722891566,0.641566265060241,"Block Group 2,  Census Tract 229.03"
060750230012,363,345,18,47,92,0.049586776859504134,0.13623188405797101,0.26666666666666666,"Block Group 2,  Census Tract 230.01"
060750231021,760,736,24,67,459,0.031578947368421054,0.09103260869565218,0.623641304347826,"Block Group 1,  Census Tract 231.02"
060750231022,512,486,26,36,346,0.05078125,0.07407407407407407,0.7119341563786008,"Block Group 2,  Census Tract 231.02"
060750231031,428,398,30,14,351,0.07009345794392523,0.035175879396984924,0.8819095477386935,"Block Group 1,  Census Tract 231.03"
060750231032,873,804,69,59,731,0.07903780068728522,0.07338308457711443,0.9092039800995025,"Block Group 2,  Census Tract 231.03"
060750232001,436,406,30,44,158,0.06880733944954129,0.10837438423645321,0.3891625615763547,"Block Group 1,  Census Tract 232"
060750234001,455,414,41,44,211,0.09010989010989011,0.10628019323671498,0.5096618357487923,"Block Group 1,  Census Tract 234"
060750252001,535,495,40,323,324,0.07476635514018691,0.6525252525252525,0.6545454545454545,"Block Group 1,  Census Tract 252"
060750253001,479,457,22,375,163,0.04592901878914405,0.8205689277899344,0.35667396061269147,"Block Group 1,  Census Tract 253"
060750254011,547,519,28,296,351,0.051188299817184646,0.5703275529865125,0.6763005780346821,"Block Group 1,  Census Tract 254.01"
060750254021,392,374,18,245,94,0.04591836734693878,0.6550802139037433,0.25133689839572193,"Block Group 1,  Census Tract 254.02"
060750255001,447,420,27,203,213,0.06040268456375839,0.48333333333333334,0.5071428571428571,"Block Group 1,  Census Tract 255"
060750255004,310,292,18,108,145,0.05806451612903226,0.3698630136986301,0.4965753424657534,"Block Group 4,  Census Tract 255"
060750256002,343,334,9,74,82,0.026239067055393587,0.2215568862275449,0.24550898203592814,"Block Group 2,  Census Tract 256"
060750257013,421,399,22,129,148,0.052256532066508314,0.3233082706766917,0.37092731829573933,"Block Group 3,  Census Tract 257.01"
060750257023,414,390,24,141,101,0.057971014492753624,0.36153846153846153,0.258974358974359,"Block Group 3,  Census Tract 257.02"
060750259001,689,639,50,266,184,0.07256894049346879,0.4162754303599374,0.28794992175273865,"Block Group 1,  Census Tract 259"
060750260012,804,767,37,299,401,0.046019900497512436,0.3898305084745763,0.5228161668839635,"Block Group 2,  Census Tract 260.01"
060750260031,625,600,25,215,196,0.04,0.35833333333333334,0.32666666666666666,"Block Group 1,  Census Tract 260.03"
060750260042,545,505,40,182,186,0.07339449541284404,0.3603960396039604,0.3683168316831683,"Block Group 2,  Census Tract 260.04"
060750261004,383,362,21,100,146,0.05483028720626632,0.27624309392265195,0.40331491712707185,"Block Group 4,  Census Tract 261"
060750263013,307,289,18,99,84,0.05863192182410423,0.34256055363321797,0.2906574394463668,"Block Group 3,  Census Tract 263.01"
060750263032,597,571,26,228,136,0.04355108877721943,0.39929947460595444,0.2381786339754816,"Block Group 2,  Census Tract 263.03"
060750264021,288,276,12,70,74,0.041666666666666664,0.2536231884057971,0.26811594202898553,"Block Group 1,  Census Tract 264.02"
060750264031,531,507,24,65,169,0.04519774011299435,0.1282051282051282,0.3333333333333333,"Block Group 1,  Census Tract 264.03"
060750264042,315,305,10,21,183,0.031746031746031744,0.06885245901639345,0.6,"Block Group 2,  Census Tract 264.04"
060750301013,410,367,43,258,274,0.1048780487804878,0.7029972752043597,0.7465940054495913,"Block Group 3,  Census Tract 301.01"
060750302011,917,859,58,583,738,0.06324972737186478,0.6786961583236322,0.8591385331781141,"Block Group 1,  Census Tract 302.01"
060750302021,777,735,42,471,588,0.05405405405405406,0.6408163265306123,0.8,"Block Group 1,  Census Tract 302.02"
060750303012,833,771,62,463,417,0.0744297719087635,0.6005188067444877,0.5408560311284046,"Block Group 2,  Census Tract 303.01"
060750303021,501,473,28,240,146,0.05588822355289421,0.507399577167019,0.3086680761099366,"Block Group 1,  Census Tract 303.02"
060750304002,420,408,12,288,60,0.02857142857142857,0.7058823529411765,0.14705882352941177,"Block Group 2,  Census Tract 304"
060750304005,357,335,22,191,179,0.06162464985994398,0.5701492537313433,0.5343283582089552,"Block Group 5,  Census Tract 304"
060750306001,296,283,13,196,47,0.04391891891891892,0.6925795053003534,0.16607773851590105,"Block Group 1,  Census Tract 306"
060750306003,307,296,11,225,29,0.035830618892508145,0.7601351351351351,0.09797297297297297,"Block Group 3,  Census Tract 306"
060750308001,352,335,17,247,64,0.048295454545454544,0.7373134328358208,0.191044776119403,"Block Group 1,  Census Tract 308"
060750309005,287,274,13,168,27,0.04529616724738676,0.6131386861313869,0.09854014598540146,"Block Group 5,  Census Tract 309"
060750310001,318,307,11,229,36,0.03459119496855346,0.745928338762215,0.11726384364820847,"Block Group 1,  Census Tract 310"
060750311002,573,545,28,319,199,0.04886561954624782,0.5853211009174312,0.3651376146788991,"Block Group 2,  Census Tract 311"
060750312011,688,651,37,117,260,0.05377906976744186,0.17972350230414746,0.39938556067588327,"Block Group 1,  Census Tract 312.01"
060750312021,401,378,23,85,105,0.057356608478802994,0.22486772486772486,0.2777777777777778,"Block Group 1,  Census Tract 312.02"
060750313013,456,443,13,156,104,0.02850877192982456,0.35214446952595935,0.23476297968397292,"Block Group 3,  Census Tract 313.01"
060750314001,233,214,19,53,41,0.0815450643776824,0.24766355140186916,0.19158878504672897,"Block Group 1,  Census Tract 314"
060750314004,408,380,28,62,161,0.06862745098039216,0.1631578947368421,0.4236842105263158,"Block Group 4,  Census Tract 314"
060750327001,313,291,22,138,91,0.07028753993610223,0.4742268041237113,0.3127147766323024,"Block Group 1,  Census Tract 327"
060750327003,478,437,41,210,225,0.08577405857740586,0.4805491990846682,0.5148741418764302,"Block Group 3,  Census Tract 327"
060750327005,294,279,15,90,69,0.05102040816326531,0.3225806451612903,0.24731182795698925,"Block Group 5,  Census Tract 327"
060750327006,315,294,21,151,85,0.06666666666666667,0.5136054421768708,0.2891156462585034,"Block Group 6,  Census Tract 327"
060750327007,325,301,24,129,118,0.07384615384615385,0.42857142857142855,0.3920265780730897,"Block Group 7,  Census Tract 327"
060750328011,537,510,27,189,215,0.05027932960893855,0.37058823529411766,0.4215686274509804,"Block Group 1,  Census Tract 328.01"
060750328013,446,430,16,187,117,0.03587443946188341,0.43488372093023253,0.27209302325581397,"Block Group 3,  Census Tract 328.01"
060750328021,545,507,38,209,218,0.06972477064220184,0.41222879684418146,0.42998027613412226,"Block Group 1,  Census Tract 328.02"
060750328023,462,437,25,170,155,0.05411255411255411,0.3890160183066362,0.35469107551487417,"Block Group 3,  Census Tract 328.02"
060750329011,413,389,24,155,120,0.05811138014527845,0.39845758354755784,0.30848329048843187,"Block Group 1,  Census Tract 329.01"
060750329013,455,435,20,181,96,0.04395604395604396,0.4160919540229885,0.2206896551724138,"Block Group 3,  Census Tract 329.01"
060750329014,488,453,35,199,203,0.07172131147540983,0.4392935982339956,0.4481236203090508,"Block Group 4,  Census Tract 329.01"
060750329022,470,445,25,145,127,0.05319148936170213,0.3258426966292135,0.2853932584269663,"Block Group 2,  Census Tract 329.02"
060750329023,482,447,35,184,126,0.07261410788381743,0.4116331096196868,0.28187919463087246,"Block Group 3,  Census Tract 329.02"
060750330001,507,488,19,256,207,0.03747534516765286,0.5245901639344263,0.42418032786885246,"Block Group 1,  Census Tract 330"
060750330003,542,523,19,293,126,0.03505535055350553,0.5602294455066922,0.24091778202676864,"Block Group 3,  Census Tract 330"
060750330004,438,413,25,211,88,0.05707762557077625,0.5108958837772397,0.21307506053268765,"Block Group 4,  Census Tract 330"
060750330006,474,457,17,205,144,0.035864978902953586,0.4485776805251641,0.3150984682713348,"Block Group 6,  Census Tract 330"
060750331001,252,237,15,134,31,0.05952380952380952,0.5654008438818565,0.1308016877637131,"Block Group 1,  Census Tract 331"
060750331003,311,301,10,146,42,0.03215434083601286,0.4850498338870432,0.13953488372093023,"Block Group 3,  Census Tract 331"
060750331004,552,527,25,244,74,0.04528985507246377,0.4629981024667932,0.14041745730550284,"Block Group 4,  Census Tract 331"
060750332011,794,647,147,329,643,0.18513853904282115,0.508500772797527,0.9938176197836167,"Block Group 1,  Census Tract 332.01"
060750332031,1008,910,98,516,910,0.09722222222222222,0.567032967032967,1,"Block Group 1,  Census Tract 332.03"
060750332041,444,411,33,190,411,0.07432432432432433,0.46228710462287104,1,"Block Group 1,  Census Tract 332.04"
060750332043,641,557,84,285,557,0.1310452418096724,0.5116696588868941,1,"Block Group 3,  Census Tract 332.04"
060750351001,507,455,52,262,259,0.10256410256410256,0.5758241758241758,0.5692307692307692,"Block Group 1,  Census Tract 351"
060750351003,450,416,34,205,167,0.07555555555555556,0.49278846153846156,0.4014423076923077,"Block Group 3,  Census Tract 351"
060750351004,288,277,11,122,86,0.03819444444444445,0.4404332129963899,0.3104693140794224,"Block Group 4,  Census Tract 351"
060750351005,346,333,13,137,100,0.03757225433526012,0.4114114114114114,0.3003003003003003,"Block Group 5,  Census Tract 351"
060750351007,467,454,13,164,147,0.027837259100642397,0.36123348017621143,0.3237885462555066,"Block Group 7,  Census Tract 351"
060750352012,347,329,18,133,108,0.05187319884726225,0.40425531914893614,0.3282674772036474,"Block Group 2,  Census Tract 352.01"
060750352013,392,369,23,185,137,0.058673469387755105,0.5013550135501355,0.3712737127371274,"Block Group 3,  Census Tract 352.01"
060750352015,353,336,17,145,123,0.04815864022662889,0.43154761904761907,0.36607142857142855,"Block Group 5,  Census Tract 352.01"
060750352021,698,647,51,351,457,0.07306590257879657,0.5425038639876353,0.7063369397217929,"Block Group 1,  Census Tract 352.02"
060750352023,565,536,29,334,338,0.05132743362831858,0.6231343283582089,0.6305970149253731,"Block Group 3,  Census Tract 352.02"
060750353001,357,338,19,123,102,0.05322128851540616,0.363905325443787,0.30177514792899407,"Block Group 1,  Census Tract 353"
060750353002,540,520,20,196,223,0.037037037037037035,0.3769230769230769,0.4288461538461538,"Block Group 2,  Census Tract 353"
060750353004,328,318,10,127,78,0.03048780487804878,0.39937106918238996,0.24528301886792453,"Block Group 4,  Census Tract 353"
060750353005,491,471,20,236,237,0.04073319755600815,0.5010615711252654,0.5031847133757962,"Block Group 5,  Census Tract 353"
060750353006,468,453,15,150,149,0.03205128205128205,0.33112582781456956,0.32891832229580575,"Block Group 6,  Census Tract 353"
060750354002,506,483,23,195,125,0.045454545454545456,0.40372670807453415,0.2587991718426501,"Block Group 2,  Census Tract 354"
060750354003,430,410,20,233,163,0.046511627906976744,0.5682926829268292,0.3975609756097561,"Block Group 3,  Census Tract 354"
060750354004,637,615,22,251,257,0.03453689167974882,0.408130081300813,0.41788617886178864,"Block Group 4,  Census Tract 354"
060750401001,375,354,21,273,175,0.056,0.7711864406779662,0.4943502824858757,"Block Group 1,  Census Tract 401"
060750401002,572,528,44,307,435,0.07692307692307693,0.5814393939393939,0.8238636363636364,"Block Group 2,  Census Tract 401"
060750401003,677,612,65,314,503,0.09601181683899557,0.5130718954248366,0.8218954248366013,"Block Group 3,  Census Tract 401"
060750402001,778,727,51,452,514,0.06555269922879177,0.6217331499312242,0.7070151306740028,"Block Group 1,  Census Tract 402"
060750402002,442,406,36,181,333,0.08144796380090498,0.4458128078817734,0.8201970443349754,"Block Group 2,  Census Tract 402"
060750402004,724,665,59,447,414,0.08149171270718232,0.6721804511278195,0.6225563909774436,"Block Group 4,  Census Tract 402"
060750426011,792,709,83,373,560,0.10479797979797979,0.5260930888575458,0.7898448519040903,"Block Group 1,  Census Tract 426.01"
060750426021,469,427,42,247,293,0.08955223880597014,0.5784543325526932,0.6861826697892272,"Block Group 1,  Census Tract 426.02"
060750426022,513,466,47,296,261,0.09161793372319688,0.6351931330472103,0.5600858369098712,"Block Group 2,  Census Tract 426.02"
060750426023,566,518,48,321,365,0.08480565371024736,0.6196911196911197,0.7046332046332047,"Block Group 3,  Census Tract 426.02"
060750427002,878,791,87,401,596,0.09908883826879271,0.506953223767383,0.7534766118836915,"Block Group 2,  Census Tract 427"
060750427003,856,791,65,419,529,0.07593457943925233,0.5297092288242731,0.6687737041719343,"Block Group 3,  Census Tract 427"
060750428001,475,448,27,327,148,0.056842105263157895,0.7299107142857143,0.33035714285714285,"Block Group 1,  Census Tract 428"
060750428002,304,267,37,222,21,0.12171052631578948,0.8314606741573034,0.07865168539325842,"Block Group 2,  Census Tract 428"
060750451001,1023,961,62,511,697,0.06060606060606061,0.5317377731529657,0.7252861602497399,"Block Group 1,  Census Tract 451"
060750451003,675,641,34,274,500,0.05037037037037037,0.42745709828393136,0.7800312012480499,"Block Group 3,  Census Tract 451"
060750452001,778,715,63,364,518,0.08097686375321336,0.509090909090909,0.7244755244755244,"Block Group 1,  Census Tract 452"
060750452002,743,691,52,376,483,0.06998654104979811,0.5441389290882779,0.6989869753979739,"Block Group 2,  Census Tract 452"
060750452004,460,424,36,200,176,0.0782608695652174,0.4716981132075472,0.41509433962264153,"Block Group 4,  Census Tract 452"
060750476001,645,603,42,300,421,0.06511627906976744,0.4975124378109453,0.6981757877280266,"Block Group 1,  Census Tract 476"
060750476003,454,420,34,199,208,0.07488986784140969,0.4738095238095238,0.49523809523809526,"Block Group 3,  Census Tract 476"
060750476004,679,632,47,346,397,0.06921944035346098,0.5474683544303798,0.6281645569620253,"Block Group 4,  Census Tract 476"
060750477012,702,659,43,295,453,0.06125356125356125,0.44764795144157815,0.6874051593323217,"Block Group 2,  Census Tract 477.01"
060750477013,588,536,52,254,329,0.08843537414965986,0.47388059701492535,0.6138059701492538,"Block Group 3,  Census Tract 477.01"
060750477022,548,514,34,249,268,0.06204379562043796,0.48443579766536965,0.5214007782101168,"Block Group 2,  Census Tract 477.02"
060750477023,652,604,48,342,389,0.0736196319018405,0.5662251655629139,0.6440397350993378,"Block Group 3,  Census Tract 477.02"
060750478012,507,473,34,205,283,0.0670611439842209,0.4334038054968288,0.5983086680761099,"Block Group 2,  Census Tract 478.01"
060750478013,743,687,56,298,382,0.07537012113055182,0.43377001455604075,0.5560407569141194,"Block Group 3,  Census Tract 478.01"
060750478021,508,470,38,267,307,0.07480314960629922,0.5680851063829787,0.6531914893617021,"Block Group 1,  Census Tract 478.02"
060750478023,622,563,59,226,372,0.09485530546623794,0.40142095914742454,0.6607460035523979,"Block Group 3,  Census Tract 478.02"
060750479011,459,426,33,188,223,0.0718954248366013,0.4413145539906103,0.5234741784037559,"Block Group 1,  Census Tract 479.01"
060750479012,788,725,63,469,418,0.0799492385786802,0.646896551724138,0.576551724137931,"Block Group 2,  Census Tract 479.01"
060750479014,500,469,31,210,208,0.062,0.44776119402985076,0.44349680170575695,"Block Group 4,  Census Tract 479.01"
060750479021,467,441,26,298,189,0.055674518201284794,0.6757369614512472,0.42857142857142855,"Block Group 1,  Census Tract 479.02"
060750479022,662,597,65,339,356,0.09818731117824774,0.5678391959798995,0.5963149078726968,"Block Group 2,  Census Tract 479.02"
060750604001,1052,1001,51,652,846,0.04847908745247148,0.6513486513486514,0.8451548451548452,"Block Group 1,  Census Tract 604"
060750605022,294,276,18,28,271,0.061224489795918366,0.10144927536231885,0.9818840579710145,"Block Group 2,  Census Tract 605.02"
060750605023,450,433,17,68,261,0.03777777777777778,0.15704387990762125,0.6027713625866051,"Block Group 3,  Census Tract 605.02"
060750607001,4025,3741,284,1949,2517,0.07055900621118012,0.5209836941994119,0.6728147554129912,"Block Group 1,  Census Tract 607"
060750607003,550,475,75,317,208,0.13636363636363635,0.6673684210526316,0.4378947368421053,"Block Group 3,  Census Tract 607"
060750610001,830,708,122,186,165,0.14698795180722893,0.2627118644067797,0.2330508474576271,"Block Group 1,  Census Tract 610"
060750610002,504,442,62,77,118,0.12301587301587301,0.17420814479638008,0.2669683257918552,"Block Group 2,  Census Tract 610"
060750611002,1113,990,123,21,944,0.1105121293800539,0.021212121212121213,0.9535353535353536,"Block Group 2,  Census Tract 611"
060750611003,570,527,43,38,527,0.07543859649122807,0.07210626185958255,1,"Block Group 3,  Census Tract 611"
060750612002,785,696,89,133,459,0.11337579617834395,0.1910919540229885,0.6594827586206896,"Block Group 2,  Census Tract 612"
060750614001,1063,970,93,472,578,0.08748824082784572,0.4865979381443299,0.5958762886597938,"Block Group 1,  Census Tract 614"
060750614002,949,872,77,558,491,0.08113804004214963,0.6399082568807339,0.5630733944954128,"Block Group 2,  Census Tract 614"
060750615001,1733,1218,515,774,915,0.2971725331794576,0.6354679802955665,0.7512315270935961,"Block Group 1,  Census Tract 615.00"
060750615002,1104,808,296,503,519,0.26811594202898553,0.6225247524752475,0.6423267326732673,"Block Group 2,  Census Tract 615.00"
060750615003,1288,1125,163,614,524,0.1265527950310559,0.5457777777777778,0.4657777777777778,"Block Group 3,  Census Tract 615.00"
060750615005,589,551,38,307,451,0.06451612903225806,0.5571687840290381,0.8185117967332124,"Block Group 5,  Census Tract 615.00"
060750615006,2236,2013,223,1286,1418,0.09973166368515206,0.6388474913065078,0.704421261798311,"Block Group 6,  Census Tract 615.00"
060759802001,68,62,6,50,26,0.08823529411764706,0.8064516129032258,0.41935483870967744,"Block Group 1,  Census Tract 9802"
060750452005,571,510,61,254,348,0.10683012259194395,0.4980392156862745,0.6823529411764706,"Block Group 5,  Census Tract 452"
060759805011,229,223,6,21,159,0.026200873362445413,0.09417040358744394,0.7130044843049327,"Block Group 1,  Census Tract 9805.01"
060759806001,163,154,9,27,55,0.05521472392638037,0.17532467532467533,0.35714285714285715,"Block Group 1,  Census Tract 9806"
060759809001,160,146,14,100,120,0.0875,0.684931506849315,0.821917808219178,"Block Group 1,  Census Tract 9809"
060750161001,367,360,7,37,312,0.01907356948228883,0.10277777777777777,0.8666666666666667,"Block Group 1,  Census Tract 161"
060750161002,930,900,30,439,781,0.03225806451612903,0.48777777777777775,0.8677777777777778,"Block Group 2,  Census Tract 161"
060750161004,954,904,50,350,881,0.05241090146750524,0.38716814159292035,0.9745575221238938,"Block Group 4,  Census Tract 161"
060750162001,488,446,42,315,379,0.0860655737704918,0.7062780269058296,0.8497757847533632,"Block Group 1,  Census Tract 162"
060750162003,554,519,35,365,488,0.0631768953068592,0.7032755298651252,0.9402697495183044,"Block Group 3,  Census Tract 162"
060750163001,523,500,23,180,464,0.04397705544933078,0.36,0.928,"Block Group 1,  Census Tract 163"
060750163003,1058,975,83,687,748,0.07844990548204159,0.7046153846153846,0.7671794871794871,"Block Group 3,  Census Tract 163"
060750164001,1129,1034,95,766,918,0.0841452612931798,0.7408123791102514,0.8878143133462283,"Block Group 1,  Census Tract 164"
060750164002,822,777,45,552,538,0.05474452554744526,0.7104247104247104,0.6924066924066924,"Block Group 2,  Census Tract 164"
060750165002,561,534,27,390,360,0.0481283422459893,0.7303370786516854,0.6741573033707865,"Block Group 2,  Census Tract 165"
060750165003,684,639,45,473,456,0.06578947368421052,0.7402190923317684,0.7136150234741784,"Block Group 3,  Census Tract 165"
060750166001,882,810,72,614,628,0.08163265306122448,0.7580246913580246,0.7753086419753087,"Block Group 1,  Census Tract 166"
060750166002,508,474,34,399,398,0.06692913385826772,0.8417721518987342,0.8396624472573839,"Block Group 2,  Census Tract 166"
060750166003,680,642,38,522,556,0.05588235294117647,0.8130841121495327,0.8660436137071651,"Block Group 3,  Census Tract 166"
060750167001,868,810,58,619,614,0.06682027649769585,0.7641975308641975,0.7580246913580246,"Block Group 1,  Census Tract 167"
060750167002,337,319,18,267,170,0.05341246290801187,0.8369905956112853,0.5329153605015674,"Block Group 2,  Census Tract 167"
060750167003,499,461,38,379,323,0.07615230460921844,0.8221258134490239,0.7006507592190889,"Block Group 3,  Census Tract 167"
060750168011,666,627,39,467,498,0.05855855855855856,0.74481658692185,0.7942583732057417,"Block Group 1,  Census Tract 168.01"
060750168013,459,437,22,355,358,0.04793028322440087,0.8123569794050344,0.8192219679633868,"Block Group 3,  Census Tract 168.01"
060750168021,693,652,41,459,515,0.05916305916305916,0.7039877300613497,0.7898773006134969,"Block Group 1,  Census Tract 168.02"
060750168023,559,533,26,410,446,0.046511627906976744,0.7692307692307693,0.8367729831144465,"Block Group 3,  Census Tract 168.02"
060750169001,1088,995,93,778,765,0.08547794117647059,0.7819095477386935,0.7688442211055276,"Block Group 1,  Census Tract 169"
060750169002,636,594,42,500,369,0.0660377358490566,0.8417508417508418,0.6212121212121212,"Block Group 2,  Census Tract 169"
060750170002,1364,1243,121,1048,655,0.08870967741935484,0.8431214802896219,0.5269509251810137,"Block Group 2,  Census Tract 170"
060750170003,432,400,32,358,160,0.07407407407407407,0.895,0.4,"Block Group 3,  Census Tract 170"
060750171011,710,639,71,560,378,0.1,0.8763693270735524,0.5915492957746479,"Block Group 1,  Census Tract 171.01"
060750171013,608,548,60,478,360,0.09868421052631579,0.8722627737226277,0.656934306569343,"Block Group 3,  Census Tract 171.01"
060750171021,652,618,34,511,427,0.05214723926380368,0.8268608414239482,0.6909385113268608,"Block Group 1,  Census Tract 171.02"
060750171023,838,766,72,627,514,0.08591885441527446,0.8185378590078329,0.6710182767624021,"Block Group 3,  Census Tract 171.02"
060750176011,22,21,1,12,21,0.045454545454545456,0.5714285714285714,1,"Block Group 1,  Census Tract 176.01"
060750176012,1869,1738,131,786,1691,0.07009095773140717,0.4522439585730725,0.9729574223245109,"Block Group 2,  Census Tract 176.01"
060750176014,504,280,224,121,256,0.4444444444444444,0.43214285714285716,0.9142857142857143,"Block Group 4,  Census Tract 176.01"
060750176015,899,771,128,326,725,0.14238042269187987,0.42282749675745784,0.940337224383917,"Block Group 5,  Census Tract 176.01"
060750177001,139,136,3,103,72,0.02158273381294964,0.7573529411764706,0.5294117647058824,"Block Group 1,  Census Tract 177"
060750177002,662,608,54,383,508,0.08157099697885196,0.6299342105263158,0.8355263157894737,"Block Group 2,  Census Tract 177"
060750178021,1677,1514,163,892,1092,0.09719737626714371,0.5891677675033025,0.7212681638044914,"Block Group 1,  Census Tract 178.02"
060750178022,748,700,48,429,555,0.06417112299465241,0.6128571428571429,0.7928571428571428,"Block Group 2,  Census Tract 178.02"
060750180002,471,451,20,297,273,0.04246284501061571,0.6585365853658537,0.6053215077605322,"Block Group 2,  Census Tract 180"
060750201001,774,724,50,442,422,0.06459948320413436,0.6104972375690608,0.5828729281767956,"Block Group 1,  Census Tract 201"
060750201003,581,542,39,273,463,0.06712564543889846,0.503690036900369,0.8542435424354243,"Block Group 3,  Census Tract 201"
060750201004,1309,1129,180,574,1020,0.13750954927425516,0.508414526129318,0.9034543844109831,"Block Group 4,  Census Tract 201"
060750202001,652,612,40,476,535,0.06134969325153374,0.7777777777777778,0.8741830065359477,"Block Group 1,  Census Tract 202"
060750202003,1413,1349,64,864,1105,0.04529370134465676,0.6404744255003706,0.8191252779836916,"Block Group 3,  Census Tract 202"
060750203001,818,763,55,577,580,0.06723716381418093,0.7562254259501966,0.7601572739187418,"Block Group 1,  Census Tract 203"
060750203003,620,579,41,440,434,0.06612903225806452,0.7599309153713298,0.7495682210708118,"Block Group 3,  Census Tract 203"
060750101001,627,558,69,373,525,0.11004784688995216,0.6684587813620072,0.9408602150537635,"Block Group 1,  Census Tract 101"
060750101002,1640,1532,108,803,1182,0.06585365853658537,0.5241514360313316,0.7715404699738904,"Block Group 2,  Census Tract 101"
060750102001,928,770,158,677,464,0.17025862068965517,0.8792207792207792,0.6025974025974026,"Block Group 1,  Census Tract 102"
060750102003,669,543,126,448,401,0.18834080717488788,0.8250460405156538,0.7384898710865562,"Block Group 3,  Census Tract 102"
060750103001,933,817,116,584,650,0.12433011789924973,0.7148102815177478,0.795593635250918,"Block Group 1,  Census Tract 103"
060750103003,787,664,123,517,441,0.156289707750953,0.7786144578313253,0.6641566265060241,"Block Group 3,  Census Tract 103"
060750104001,274,255,19,118,190,0.06934306569343066,0.4627450980392157,0.7450980392156863,"Block Group 1,  Census Tract 104"
060750104003,1134,920,214,729,558,0.18871252204585537,0.7923913043478261,0.6065217391304348,"Block Group 3,  Census Tract 104"
060750104004,555,475,80,370,366,0.14414414414414414,0.7789473684210526,0.7705263157894737,"Block Group 4,  Census Tract 104"
060750105001,596,510,86,340,216,0.14429530201342283,0.6666666666666666,0.4235294117647059,"Block Group 1,  Census Tract 105"
060750106001,717,617,100,383,540,0.1394700139470014,0.6207455429497569,0.8752025931928687,"Block Group 1,  Census Tract 106"
060750106002,852,753,99,268,683,0.11619718309859155,0.3559096945551129,0.9070385126162018,"Block Group 2,  Census Tract 106"
060750106003,717,645,72,296,610,0.100418410041841,0.45891472868217054,0.9457364341085271,"Block Group 3,  Census Tract 106"
060750107002,594,545,49,134,503,0.08249158249158249,0.24587155963302754,0.9229357798165138,"Block Group 2,  Census Tract 107"
060750107003,953,880,73,68,847,0.07660020986358866,0.07727272727272727,0.9625,"Block Group 3,  Census Tract 107"
060750108001,804,623,181,473,332,0.22512437810945274,0.7592295345104334,0.5329052969502408,"Block Group 1,  Census Tract 108"
060750108002,881,790,91,336,645,0.10329171396140749,0.4253164556962025,0.8164556962025317,"Block Group 2,  Census Tract 108"
060750109001,693,605,88,477,434,0.12698412698412698,0.7884297520661157,0.7173553719008264,"Block Group 1,  Census Tract 109"
060750109002,1048,948,100,708,718,0.09541984732824428,0.7468354430379747,0.7573839662447257,"Block Group 2,  Census Tract 109"
060750109003,1150,1075,75,759,950,0.06521739130434782,0.706046511627907,0.8837209302325582,"Block Group 3,  Census Tract 109"
060750110002,1027,909,118,445,757,0.11489776046738072,0.48954895489548955,0.8327832783278328,"Block Group 2,  Census Tract 110"
060750110003,1147,1062,85,612,949,0.07410636442894507,0.576271186440678,0.8935969868173258,"Block Group 3,  Census Tract 110"
060750111002,1438,1262,176,769,1153,0.12239221140472879,0.6093502377179081,0.9136291600633915,"Block Group 2,  Census Tract 111"
060750111003,655,602,53,359,563,0.08091603053435115,0.5963455149501661,0.9352159468438538,"Block Group 3,  Census Tract 111"
060750112001,912,761,151,412,599,0.16557017543859648,0.5413929040735874,0.7871222076215506,"Block Group 1,  Census Tract 112"
060750112003,497,380,117,281,278,0.23541247484909456,0.7394736842105263,0.7315789473684211,"Block Group 3,  Census Tract 112"
060750113001,696,635,61,90,577,0.08764367816091954,0.14173228346456693,0.9086614173228347,"Block Group 1,  Census Tract 113"
060750113002,979,892,87,246,792,0.0888661899897855,0.2757847533632287,0.8878923766816144,"Block Group 2,  Census Tract 113"
060750117002,909,582,327,284,525,0.35973597359735976,0.4879725085910653,0.9020618556701031,"Block Group 2,  Census Tract 117"
060750118001,800,695,105,83,682,0.13125,0.11942446043165468,0.981294964028777,"Block Group 1,  Census Tract 118"
060750119012,958,797,161,500,582,0.16805845511482254,0.6273525721455459,0.7302383939774153,"Block Group 2,  Census Tract 119.01"
060750119021,1516,1301,215,856,1267,0.14182058047493404,0.6579554189085319,0.9738662567255957,"Block Group 1,  Census Tract 119.02"
060750120001,1524,1381,143,849,1365,0.09383202099737532,0.6147719044170891,0.9884141926140478,"Block Group 1,  Census Tract 120"
060750120002,1272,1165,107,639,1148,0.08411949685534591,0.5484978540772533,0.9854077253218884,"Block Group 2,  Census Tract 120"
060750121001,1780,1622,158,1034,1545,0.08876404494382023,0.6374845869297164,0.9525277435265105,"Block Group 1,  Census Tract 121"
060750122011,1655,1552,103,869,1530,0.062235649546827795,0.5599226804123711,0.9858247422680413,"Block Group 1,  Census Tract 122.01"
060750122012,1251,1115,136,588,985,0.10871302957633892,0.5273542600896861,0.8834080717488789,"Block Group 2,  Census Tract 122.01"
060750122021,1633,1514,119,720,1475,0.07287201469687692,0.47556142668428003,0.9742404227212682,"Block Group 1,  Census Tract 122.02"
060750123012,749,656,93,321,650,0.12416555407209613,0.4893292682926829,0.9908536585365854,"Block Group 2,  Census Tract 123.01"
060750123022,1210,996,214,461,992,0.1768595041322314,0.46285140562248994,0.9959839357429718,"Block Group 2,  Census Tract 123.02"
060750124011,1169,1083,86,475,1075,0.07356715141146279,0.43859649122807015,0.9926131117266851,"Block Group 1,  Census Tract 124.01"
060750204011,578,520,58,441,262,0.10034602076124567,0.8480769230769231,0.5038461538461538,"Block Group 1,  Census Tract 204.01"
060750204012,468,419,49,337,249,0.1047008547008547,0.8042959427207638,0.594272076372315,"Block Group 2,  Census Tract 204.01"
060750204021,1413,1325,88,952,1051,0.06227883934890304,0.7184905660377359,0.7932075471698113,"Block Group 1,  Census Tract 204.02"
060750204022,1188,1084,104,894,662,0.08754208754208755,0.8247232472324724,0.6107011070110702,"Block Group 2,  Census Tract 204.02"
060750205002,469,442,27,360,291,0.057569296375266525,0.8144796380090498,0.6583710407239819,"Block Group 2,  Census Tract 205"
060750205003,502,477,25,418,211,0.049800796812749,0.8763102725366876,0.44234800838574423,"Block Group 3,  Census Tract 205"
060750206001,985,927,58,733,694,0.05888324873096447,0.790722761596548,0.7486515641855448,"Block Group 1,  Census Tract 206"
060750206002,480,443,37,389,260,0.07708333333333334,0.8781038374717833,0.5869074492099323,"Block Group 2,  Census Tract 206"
060750206004,836,767,69,650,484,0.08253588516746412,0.847457627118644,0.6310299869621904,"Block Group 4,  Census Tract 206"
060750207002,1103,1046,57,819,786,0.051677243880326386,0.7829827915869981,0.751434034416826,"Block Group 2,  Census Tract 207"
060750207003,496,457,39,385,330,0.07862903225806452,0.8424507658643327,0.7221006564551422,"Block Group 3,  Census Tract 207"
060750208001,571,541,30,298,450,0.05253940455341506,0.5508317929759704,0.8317929759704251,"Block Group 1,  Census Tract 208"
060750208003,682,597,85,379,468,0.12463343108504399,0.6348408710217756,0.7839195979899497,"Block Group 3,  Census Tract 208"
060750208004,788,755,33,422,689,0.04187817258883249,0.5589403973509933,0.9125827814569536,"Block Group 4,  Census Tract 208"
060750209002,357,336,21,191,288,0.058823529411764705,0.5684523809523809,0.8571428571428571,"Block Group 2,  Census Tract 209"
060750209003,340,254,86,171,220,0.2529411764705882,0.6732283464566929,0.8661417322834646,"Block Group 3,  Census Tract 209"
060750209004,505,487,18,332,425,0.03564356435643564,0.6817248459958932,0.8726899383983573,"Block Group 4,  Census Tract 209"
060750210002,508,482,26,387,374,0.051181102362204724,0.8029045643153527,0.7759336099585062,"Block Group 2,  Census Tract 210"
060750210003,770,722,48,573,531,0.06233766233766234,0.7936288088642659,0.7354570637119113,"Block Group 3,  Census Tract 210"
060750210004,362,335,27,232,254,0.07458563535911603,0.6925373134328359,0.7582089552238805,"Block Group 4,  Census Tract 210"
060750211002,497,455,42,372,355,0.08450704225352113,0.8175824175824176,0.7802197802197802,"Block Group 2,  Census Tract 211"
060750211003,521,483,38,405,288,0.07293666026871401,0.8385093167701864,0.5962732919254659,"Block Group 3,  Census Tract 211"
060750211004,420,384,36,336,136,0.08571428571428572,0.875,0.3541666666666667,"Block Group 4,  Census Tract 211"
060750212002,603,553,50,467,270,0.08291873963515754,0.8444846292947559,0.488245931283906,"Block Group 2,  Census Tract 212"
060750212003,414,388,26,330,162,0.06280193236714976,0.8505154639175257,0.4175257731958763,"Block Group 3,  Census Tract 212"
060750213002,707,663,44,557,267,0.06223479490806223,0.8401206636500754,0.40271493212669685,"Block Group 2,  Census Tract 213"
060750214001,403,378,25,314,238,0.062034739454094295,0.8306878306878307,0.6296296296296297,"Block Group 1,  Census Tract 214"
060750214002,749,675,74,551,378,0.09879839786381843,0.8162962962962963,0.56,"Block Group 2,  Census Tract 214"
060750215001,505,465,40,362,270,0.07920792079207921,0.7784946236559139,0.5806451612903226,"Block Group 1,  Census Tract 215"
060750215002,631,589,42,451,352,0.06656101426307448,0.765704584040747,0.597623089983022,"Block Group 2,  Census Tract 215"
060750215004,540,503,37,396,269,0.06851851851851852,0.7872763419483101,0.5347912524850894,"Block Group 4,  Census Tract 215"
060750215005,511,473,38,403,257,0.07436399217221135,0.8520084566596194,0.5433403805496829,"Block Group 5,  Census Tract 215"
060750216001,959,893,66,725,368,0.06882168925964546,0.8118701007838746,0.41209406494960804,"Block Group 1,  Census Tract 216"
060750216002,1206,1133,73,691,439,0.06053067993366501,0.6098852603706972,0.38746690203000883,"Block Group 2,  Census Tract 216"
060750217001,636,611,25,399,117,0.03930817610062893,0.6530278232405892,0.19148936170212766,"Block Group 1,  Census Tract 217"
060750217003,764,723,41,471,314,0.05366492146596859,0.6514522821576764,0.4343015214384509,"Block Group 3,  Census Tract 217"
060750218002,517,486,31,407,180,0.059961315280464215,0.8374485596707819,0.37037037037037035,"Block Group 2,  Census Tract 218"
060750124012,1765,1615,150,670,1610,0.08498583569405099,0.4148606811145511,0.9969040247678018,"Block Group 2,  Census Tract 124.01"
060750124022,703,616,87,431,615,0.12375533428165007,0.6996753246753247,0.9983766233766234,"Block Group 2,  Census Tract 124.02"
060750124023,1326,1198,128,591,1105,0.09653092006033183,0.493322203672788,0.9223706176961602,"Block Group 3,  Census Tract 124.02"
060750125011,1214,1118,96,435,1088,0.07907742998352553,0.389087656529517,0.9731663685152058,"Block Group 1,  Census Tract 125.01"
060750125012,1304,1087,217,509,1062,0.1664110429447853,0.46826126954921804,0.9770009199632015,"Block Group 2,  Census Tract 125.01"
060750126011,1640,1496,144,1303,1211,0.08780487804878048,0.8709893048128342,0.8094919786096256,"Block Group 1,  Census Tract 126.01"
060750126021,978,910,68,802,673,0.06952965235173825,0.8813186813186813,0.7395604395604396,"Block Group 1,  Census Tract 126.02"
060750126022,946,814,132,700,635,0.13953488372093023,0.85995085995086,0.7800982800982801,"Block Group 2,  Census Tract 126.02"
060750127002,786,727,59,637,551,0.07506361323155217,0.8762035763411279,0.7579092159559835,"Block Group 2,  Census Tract 127"
060750127003,496,462,34,419,361,0.06854838709677419,0.9069264069264069,0.7813852813852814,"Block Group 3,  Census Tract 127"
060750128001,1032,934,98,814,683,0.09496124031007752,0.8715203426124197,0.7312633832976445,"Block Group 1,  Census Tract 128"
060750128003,605,542,63,456,370,0.10413223140495868,0.8413284132841329,0.6826568265682657,"Block Group 3,  Census Tract 128"
060750128004,565,504,61,411,439,0.1079646017699115,0.8154761904761905,0.871031746031746,"Block Group 4,  Census Tract 128"
060750129012,867,795,72,671,611,0.08304498269896193,0.8440251572327044,0.7685534591194969,"Block Group 2,  Census Tract 129.01"
060750129021,854,777,77,634,635,0.09016393442622951,0.8159588159588159,0.8172458172458172,"Block Group 1,  Census Tract 129.02"
060750129023,583,538,45,441,437,0.07718696397941681,0.8197026022304833,0.8122676579925651,"Block Group 3,  Census Tract 129.02"
060750130001,778,726,52,617,601,0.06683804627249357,0.849862258953168,0.8278236914600551,"Block Group 1,  Census Tract 130"
060750130003,656,582,74,509,433,0.11280487804878049,0.8745704467353952,0.7439862542955327,"Block Group 3,  Census Tract 130"
060750130004,625,535,90,464,381,0.144,0.8672897196261682,0.7121495327102804,"Block Group 4,  Census Tract 130"
060750131011,1097,982,115,813,804,0.1048313582497721,0.8279022403258656,0.8187372708757638,"Block Group 1,  Census Tract 131.01"
060750131021,901,819,82,671,680,0.09100998890122086,0.8192918192918193,0.8302808302808303,"Block Group 1,  Census Tract 131.02"
060750131022,851,763,88,637,537,0.10340775558166862,0.8348623853211009,0.7038007863695938,"Block Group 2,  Census Tract 131.02"
060750132002,382,332,50,281,170,0.13089005235602094,0.8463855421686747,0.5120481927710844,"Block Group 2,  Census Tract 132"
060750132003,703,614,89,545,192,0.12660028449502134,0.8876221498371335,0.3127035830618892,"Block Group 3,  Census Tract 132"
060750133001,294,268,26,251,81,0.08843537414965986,0.9365671641791045,0.30223880597014924,"Block Group 1,  Census Tract 133"
060750133003,529,492,37,380,397,0.06994328922495274,0.7723577235772358,0.806910569105691,"Block Group 3,  Census Tract 133"
060750133004,341,298,43,264,86,0.12609970674486803,0.8859060402684564,0.28859060402684567,"Block Group 4,  Census Tract 133"
060750134001,510,445,65,367,336,0.12745098039215685,0.8247191011235955,0.75505617977528094,"Block Group 1,  Census Tract 134"
060750134002,853,793,60,657,582,0.07033997655334115,0.8284993694829761,0.733921815889029,"Block Group 2,  Census Tract 134"
060750134003,817,741,76,651,417,0.09302325581395349,0.8785425101214575,0.562753036437247,"Block Group 3,  Census Tract 134"
060750135002,1008,866,142,678,654,0.14087301587301587,0.7829099307159353,0.7551963048498845,"Block Group 2,  Census Tract 135"
060750151001,1105,1038,67,756,880,0.06063348416289593,0.7283236994219653,0.8477842003853564,"Block Group 1,  Census Tract 151"
060750151002,799,617,182,348,340,0.22778473091364204,0.5640194489465153,0.5510534846029174,"Block Group 2,  Census Tract 151"
060750152003,483,452,31,320,226,0.06418219461697723,0.7079646017699115,0.5,"Block Group 3,  Census Tract 152"
060750153001,496,459,37,357,319,0.07459677419354839,0.7777777777777778,0.6949891067538126,"Block Group 1,  Census Tract 153"
060750153002,555,498,57,371,308,0.10270270270270271,0.7449799196787149,0.6184738955823293,"Block Group 2,  Census Tract 153"
060750154002,627,568,59,392,426,0.09409888357256778,0.6901408450704225,0.75,"Block Group 2,  Census Tract 154"
060750154003,858,773,85,489,595,0.09906759906759907,0.6326002587322122,0.7697283311772316,"Block Group 3,  Census Tract 154"
060750154005,742,698,44,546,444,0.05929919137466307,0.7822349570200573,0.6361031518624641,"Block Group 5,  Census Tract 154"
060750218003,319,300,19,240,107,0.05956112852664577,0.8,0.3566666666666667,"Block Group 3,  Census Tract 218"
060750218004,471,446,25,358,170,0.05307855626326964,0.8026905829596412,0.3811659192825112,"Block Group 4,  Census Tract 218"
060750226001,352,332,20,253,167,0.056818181818181816,0.7620481927710844,0.5030120481927711,"Block Group 1,  Census Tract 226"
060750227022,515,481,34,405,240,0.06601941747572816,0.841995841995842,0.498960498960499,"Block Group 2,  Census Tract 227.02"
060750227041,701,667,34,506,300,0.04850213980028531,0.7586206896551724,0.4497751124437781,"Block Group 1,  Census Tract 227.04"
060750227042,1016,944,72,798,445,0.07086614173228346,0.8453389830508474,0.4713983050847458,"Block Group 2,  Census Tract 227.04"
060750228011,633,598,35,392,380,0.05529225908372828,0.6555183946488294,0.6354515050167224,"Block Group 1,  Census Tract 228.01"
060750228013,593,561,32,362,378,0.05396290050590219,0.6452762923351159,0.6737967914438503,"Block Group 3,  Census Tract 228.01"
060750228022,373,355,18,205,237,0.04825737265415549,0.5774647887323944,0.6676056338028169,"Block Group 2,  Census Tract 228.02"
060750228031,728,705,23,466,551,0.03159340659340659,0.6609929078014184,0.7815602836879433,"Block Group 1,  Census Tract 228.03"
060750228033,434,411,23,250,284,0.052995391705069124,0.6082725060827251,0.6909975669099757,"Block Group 3,  Census Tract 228.03"
060750229011,617,590,27,351,444,0.04376012965964344,0.5949152542372881,0.752542372881356,"Block Group 1,  Census Tract 229.01"
060750229012,541,493,48,233,412,0.08872458410351201,0.4726166328600406,0.8356997971602435,"Block Group 2,  Census Tract 229.01"
060750229021,437,414,23,267,265,0.05263157894736842,0.644927536231884,0.6400966183574879,"Block Group 1,  Census Tract 229.02"
060750229022,402,388,14,241,249,0.03482587064676617,0.6211340206185567,0.6417525773195877,"Block Group 2,  Census Tract 229.02"
060750229031,496,471,25,253,328,0.05040322580645161,0.5371549893842887,0.6963906581740976,"Block Group 1,  Census Tract 229.03"
060750229033,321,315,6,198,172,0.018691588785046728,0.6285714285714286,0.546031746031746,"Block Group 3,  Census Tract 229.03"
060750230011,496,472,24,62,149,0.04838709677419355,0.13135593220338984,0.3156779661016949,"Block Group 1,  Census Tract 230.01"
060750230013,521,495,26,83,132,0.04990403071017274,0.16767676767676767,0.26666666666666666,"Block Group 3,  Census Tract 230.01"
060750230031,816,785,31,141,185,0.03799019607843137,0.17961783439490445,0.2356687898089172,"Block Group 1,  Census Tract 230.03"
060750230032,397,369,28,58,183,0.07052896725440806,0.15718157181571815,0.4959349593495935,"Block Group 2,  Census Tract 230.03"
060750155001,1190,1053,137,551,843,0.11512605042016806,0.5232668566001899,0.8005698005698005,"Block Group 1,  Census Tract 155"
060750155002,929,830,99,421,795,0.10656620021528525,0.5072289156626506,0.95783132530120485,"Block Group 2,  Census Tract 155"
060750156001,373,335,38,172,217,0.10187667560321716,0.5134328358208955,0.6477611940298508,"Block Group 1,  Census Tract 156"
060750156002,612,558,54,382,429,0.08823529411764706,0.6845878136200717,0.7688172043010753,"Block Group 2,  Census Tract 156"
060750156003,415,379,36,236,201,0.08674698795180723,0.6226912928759895,0.5303430079155673,"Block Group 3,  Census Tract 156"
060750157002,919,874,45,626,561,0.04896626768226333,0.7162471395881007,0.6418764302059496,"Block Group 2,  Census Tract 157"
060750157003,737,683,54,392,494,0.07327001356852103,0.5739385065885798,0.7232796486090776,"Block Group 3,  Census Tract 157"
060750157004,459,429,30,298,277,0.06535947712418301,0.6946386946386947,0.6456876456876457,"Block Group 4,  Census Tract 157"
060750232003,444,413,31,79,207,0.06981981981981981,0.19128329297820823,0.5012106537530266,"Block Group 3,  Census Tract 232"
060750233001,1000,620,380,69,226,0.38,0.11129032258064517,0.36451612903225805,"Block Group 1,  Census Tract 233"
060750234002,589,550,39,42,367,0.06621392190152801,0.07636363636363637,0.6672727272727272,"Block Group 2,  Census Tract 234"
060750251001,643,602,41,450,232,0.06376360808709176,0.7475083056478405,0.3853820598006645,"Block Group 1,  Census Tract 251"
060750251002,398,375,23,272,98,0.05778894472361809,0.7253333333333334,0.2613333333333333,"Block Group 2,  Census Tract 251"
060750251003,316,292,24,182,75,0.0759493670886076,0.6232876712328768,0.2568493150684932,"Block Group 3,  Census Tract 251"
060750252002,669,634,35,526,275,0.052316890881913304,0.8296529968454258,0.43375394321766564,"Block Group 2,  Census Tract 252"
060750252003,554,519,35,388,130,0.0631768953068592,0.7475915221579962,0.2504816955684008,"Block Group 3,  Census Tract 252"
060750252004,499,477,22,379,138,0.04408817635270541,0.7945492662473794,0.2893081761006289,"Block Group 4,  Census Tract 252"
060750253002,363,344,19,288,141,0.05234159779614325,0.8372093023255814,0.40988372093023256,"Block Group 2,  Census Tract 253"
060750253003,380,338,42,203,270,0.11052631578947368,0.6005917159763313,0.7988165680473372,"Block Group 3,  Census Tract 253"
060750253004,659,628,31,435,441,0.04704097116843703,0.6926751592356688,0.7022292993630573,"Block Group 4,  Census Tract 253"
060750254012,386,366,20,279,147,0.05181347150259067,0.7622950819672131,0.4016393442622951,"Block Group 2,  Census Tract 254.01"
060750254013,419,391,28,249,223,0.06682577565632458,0.6368286445012787,0.5703324808184144,"Block Group 3,  Census Tract 254.01"
060750254022,326,306,20,178,91,0.06134969325153374,0.5816993464052288,0.2973856209150327,"Block Group 2,  Census Tract 254.02"
060750254023,389,380,9,222,129,0.02313624678663239,0.5842105263157895,0.3394736842105263,"Block Group 3,  Census Tract 254.02"
060750254031,669,631,38,381,288,0.05680119581464873,0.6038034865293186,0.45641838351822506,"Block Group 1,  Census Tract 254.03"
060750254032,862,805,57,357,390,0.06612529002320186,0.4434782608695652,0.484472049689441,"Block Group 2,  Census Tract 254.03"
060750255002,369,348,21,151,141,0.056910569105691054,0.4339080459770115,0.4051724137931034,"Block Group 2,  Census Tract 255"
060750255003,310,298,12,157,121,0.03870967741935484,0.5268456375838926,0.40604026845637586,"Block Group 3,  Census Tract 255"
060750255005,434,414,20,196,126,0.04608294930875576,0.47342995169082125,0.30434782608695654,"Block Group 5,  Census Tract 255"
060750255006,716,697,19,355,197,0.02653631284916201,0.509325681492109,0.28263988522238165,"Block Group 6,  Census Tract 255"
060750256001,437,417,20,121,110,0.04576659038901602,0.290167865707434,0.2637889688249401,"Block Group 1,  Census Tract 256"
060750256003,330,316,14,117,60,0.04242424242424243,0.370253164556962,0.189873417721519,"Block Group 3,  Census Tract 256"
060750256004,519,491,28,170,186,0.05394990366088632,0.34623217922606925,0.3788187372708758,"Block Group 4,  Census Tract 256"
060750257011,371,353,18,133,64,0.04851752021563342,0.37677053824362605,0.1813031161473088,"Block Group 1,  Census Tract 257.01"
060750257012,612,579,33,153,252,0.05392156862745098,0.26424870466321243,0.43523316062176165,"Block Group 2,  Census Tract 257.01"
060750257021,381,371,10,79,235,0.026246719160104987,0.21293800539083557,0.633423180592992,"Block Group 1,  Census Tract 257.02"
060750257022,496,468,28,123,252,0.056451612903225805,0.26282051282051283,0.5384615384615384,"Block Group 2,  Census Tract 257.02"
060750258001,367,343,24,94,125,0.0653950953678474,0.27405247813411077,0.36443148688046645,"Block Group 1,  Census Tract 258"
060750258002,246,229,17,52,119,0.06910569105691057,0.22707423580786026,0.519650655021834,"Block Group 2,  Census Tract 258"
060750259002,555,531,24,169,111,0.043243243243243246,0.3182674199623352,0.20903954802259886,"Block Group 2,  Census Tract 259"
060750259003,166,157,9,40,37,0.05421686746987952,0.25477707006369427,0.2356687898089172,"Block Group 3,  Census Tract 259"
060750260011,775,752,23,286,352,0.02967741935483871,0.3803191489361702,0.46808510638297873,"Block Group 1,  Census Tract 260.01"
060750260021,405,387,18,161,108,0.044444444444444446,0.4160206718346253,0.27906976744186046,"Block Group 1,  Census Tract 260.02"
060750260022,579,568,11,234,128,0.018998272884283247,0.4119718309859155,0.22535211267605634,"Block Group 2,  Census Tract 260.02"
060750260032,744,714,30,292,243,0.04032258064516129,0.40896358543417366,0.3403361344537815,"Block Group 2,  Census Tract 260.03"
060750260041,660,639,21,214,280,0.031818181818181815,0.3348982785602504,0.4381846635367762,"Block Group 1,  Census Tract 260.04"
060750261001,501,484,17,129,279,0.033932135728542916,0.2665289256198347,0.5764462809917356,"Block Group 1,  Census Tract 261"
060750261002,699,673,26,159,265,0.03719599427753934,0.2362555720653789,0.3937592867756315,"Block Group 2,  Census Tract 261"
060750261003,370,358,12,102,103,0.032432432432432434,0.2849162011173184,0.2877094972067039,"Block Group 3,  Census Tract 261"
060750262001,541,519,22,173,197,0.04066543438077634,0.3333333333333333,0.37957610789980734,"Block Group 1,  Census Tract 262"
060750262002,381,361,20,86,127,0.05249343832020997,0.23822714681440443,0.3518005540166205,"Block Group 2,  Census Tract 262"
060750262003,372,351,21,87,150,0.056451612903225805,0.24786324786324787,0.42735042735042733,"Block Group 3,  Census Tract 262"
060750262005,317,303,14,79,92,0.04416403785488959,0.2607260726072607,0.30363036303630364,"Block Group 5,  Census Tract 262"
060750263011,345,326,19,87,144,0.05507246376811594,0.2668711656441718,0.44171779141104295,"Block Group 1,  Census Tract 263.01"
060750263012,691,658,33,175,285,0.04775687409551375,0.26595744680851063,0.4331306990881459,"Block Group 2,  Census Tract 263.01"
060750263021,353,339,14,115,133,0.039660056657223795,0.3392330383480826,0.39233038348082594,"Block Group 1,  Census Tract 263.02"
060750263022,346,327,19,115,84,0.05491329479768786,0.3516819571865443,0.25688073394495414,"Block Group 2,  Census Tract 263.02"
060750263023,824,782,42,234,297,0.050970873786407765,0.29923273657289,0.3797953964194373,"Block Group 3,  Census Tract 263.02"
060750263031,702,662,40,136,305,0.05698005698005698,0.2054380664652568,0.4607250755287009,"Block Group 1,  Census Tract 263.03"
060750264011,572,546,26,47,209,0.045454545454545456,0.08608058608058608,0.38278388278388276,"Block Group 1,  Census Tract 264.01"
060750264012,490,470,20,69,143,0.04081632653061224,0.14680851063829786,0.30425531914893617,"Block Group 2,  Census Tract 264.01"
060750264022,434,403,31,85,137,0.07142857142857142,0.2109181141439206,0.3399503722084367,"Block Group 2,  Census Tract 264.02"
060750264023,446,429,17,118,119,0.03811659192825112,0.27505827505827507,0.2773892773892774,"Block Group 3,  Census Tract 264.02"
060750264032,589,555,34,108,255,0.057724957555178265,0.1945945945945946,0.4594594594594595,"Block Group 2,  Census Tract 264.03"
060750264041,384,366,18,50,137,0.046875,0.1366120218579235,0.3743169398907104,"Block Group 1,  Census Tract 264.04"
060750301011,715,682,33,503,461,0.046153846153846156,0.7375366568914956,0.6759530791788856,"Block Group 1,  Census Tract 301.01"
060750301012,602,550,52,406,446,0.08637873754152824,0.7381818181818182,0.8109090909090909,"Block Group 2,  Census Tract 301.01"
060750301014,431,398,33,280,256,0.0765661252900232,0.7035175879396985,0.6432160804020101,"Block Group 4,  Census Tract 301.01"
060750301021,1249,1174,75,859,819,0.0600480384307446,0.731686541737649,0.6976149914821125,"Block Group 1,  Census Tract 301.02"
060750301022,629,595,34,377,258,0.05405405405405406,0.6336134453781512,0.4336134453781513,"Block Group 2,  Census Tract 301.02"
060750301023,460,434,26,374,166,0.05652173913043478,0.8617511520737328,0.3824884792626728,"Block Group 3,  Census Tract 301.02"
060750302012,499,477,22,267,333,0.04408817635270541,0.559748427672956,0.6981132075471698,"Block Group 2,  Census Tract 302.01"
060750302013,534,506,28,312,289,0.052434456928838954,0.616600790513834,0.5711462450592886,"Block Group 3,  Census Tract 302.01"
060750302022,757,705,52,430,568,0.06869220607661823,0.6099290780141844,0.8056737588652483,"Block Group 2,  Census Tract 302.02"
060750302023,695,644,51,418,467,0.07338129496402877,0.6490683229813664,0.7251552795031055,"Block Group 3,  Census Tract 302.02"
060750303011,501,476,25,252,199,0.0499001996007984,0.5294117647058824,0.4180672268907563,"Block Group 1,  Census Tract 303.01"
060750303013,712,664,48,393,350,0.06741573033707865,0.5918674698795181,0.5271084337349398,"Block Group 3,  Census Tract 303.01"
060750303014,476,451,25,250,133,0.052521008403361345,0.5543237250554324,0.29490022172949004,"Block Group 4,  Census Tract 303.01"
060750303022,455,435,20,288,86,0.04395604395604396,0.6620689655172414,0.19770114942528735,"Block Group 2,  Census Tract 303.02"
060750303023,496,466,30,248,130,0.06048387096774194,0.5321888412017167,0.27896995708154504,"Block Group 3,  Census Tract 303.02"
060750304001,409,403,6,291,57,0.014669926650366748,0.7220843672456576,0.141439205955335,"Block Group 1,  Census Tract 304"
060750304003,534,509,25,261,120,0.04681647940074907,0.5127701375245579,0.2357563850687623,"Block Group 3,  Census Tract 304"
060750304004,284,278,6,137,74,0.02112676056338028,0.49280575539568344,0.26618705035971224,"Block Group 4,  Census Tract 304"
060750305001,396,369,27,267,64,0.06818181818181818,0.7235772357723578,0.17344173441734417,"Block Group 1,  Census Tract 305"
060750305002,357,345,12,217,75,0.03361344537815126,0.6289855072463768,0.21739130434782608,"Block Group 2,  Census Tract 305"
060750305003,303,292,11,189,137,0.036303630363036306,0.6472602739726028,0.4691780821917808,"Block Group 3,  Census Tract 305"
060750306002,298,286,12,199,65,0.040268456375838924,0.6958041958041958,0.22727272727272727,"Block Group 2,  Census Tract 306"
060750307001,1105,1067,38,759,155,0.034389140271493215,0.711340206185567,0.14526710402999063,"Block Group 1,  Census Tract 307"
060750307002,690,672,18,485,113,0.02608695652173913,0.7217261904761905,0.16815476190476192,"Block Group 2,  Census Tract 307"
060750307003,952,912,40,586,140,0.04201680672268908,0.6425438596491229,0.15350877192982457,"Block Group 3,  Census Tract 307"
060750308002,283,272,11,197,25,0.038869257950530034,0.7242647058823529,0.09191176470588236,"Block Group 2,  Census Tract 308"
060750308003,268,257,11,182,27,0.041044776119402986,0.708171206225681,0.10505836575875487,"Block Group 3,  Census Tract 308"
060750308004,776,671,105,501,187,0.13530927835051546,0.7466467958271237,0.2786885245901639,"Block Group 4,  Census Tract 308"
060750309001,350,343,7,253,22,0.02,0.7376093294460642,0.0641399416909621,"Block Group 1,  Census Tract 309"
060750309002,517,500,17,310,56,0.03288201160541586,0.62,0.112,"Block Group 2,  Census Tract 309"
060750309003,419,404,15,227,44,0.03579952267303103,0.5618811881188119,0.10891089108910891,"Block Group 3,  Census Tract 309"
060750309004,292,282,10,192,20,0.03424657534246575,0.6808510638297872,0.07092198581560284,"Block Group 4,  Census Tract 309"
060750309006,227,213,14,143,36,0.06167400881057269,0.6713615023474179,0.16901408450704225,"Block Group 6,  Census Tract 309"
060750309007,343,329,14,172,46,0.04081632653061224,0.5227963525835866,0.1398176291793313,"Block Group 7,  Census Tract 309"
060750310003,589,556,33,315,118,0.05602716468590832,0.5665467625899281,0.21223021582733814,"Block Group 3,  Census Tract 310"
060750311001,473,435,38,294,180,0.080338266384778,0.6758620689655173,0.41379310344827586,"Block Group 1,  Census Tract 311"
060750311003,271,263,8,150,62,0.02952029520295203,0.5703422053231939,0.23574144486692014,"Block Group 3,  Census Tract 311"
060750311004,505,481,24,288,163,0.047524752475247525,0.5987525987525988,0.3388773388773389,"Block Group 4,  Census Tract 311"
060750311005,768,738,30,464,289,0.0390625,0.6287262872628726,0.3915989159891599,"Block Group 5,  Census Tract 311"
060750312012,520,477,43,125,288,0.08269230769230769,0.2620545073375262,0.6037735849056604,"Block Group 2,  Census Tract 312.01"
060750312013,277,258,19,94,121,0.06859205776173286,0.3643410852713178,0.4689922480620155,"Block Group 3,  Census Tract 312.01"
060750312014,376,354,22,109,96,0.05851063829787234,0.307909604519774,0.2711864406779661,"Block Group 4,  Census Tract 312.01"
060750312022,478,459,19,97,139,0.0397489539748954,0.2113289760348584,0.3028322440087146,"Block Group 2,  Census Tract 312.02"
060750313011,343,330,13,102,96,0.037900874635568516,0.3090909090909091,0.2909090909090909,"Block Group 1,  Census Tract 313.01"
060750313012,505,488,17,137,128,0.033663366336633666,0.2807377049180328,0.26229508196721313,"Block Group 2,  Census Tract 313.01"
060750313021,453,429,24,66,128,0.052980132450331126,0.15384615384615385,0.29836829836829837,"Block Group 1,  Census Tract 313.02"
060750313022,464,429,35,102,156,0.07543103448275862,0.23776223776223776,0.36363636363636365,"Block Group 2,  Census Tract 313.02"
060750313023,984,919,65,246,315,0.06605691056910569,0.2676822633297062,0.34276387377584333,"Block Group 3,  Census Tract 313.02"
060750314002,459,434,25,97,164,0.054466230936819175,0.22350230414746544,0.3778801843317972,"Block Group 2,  Census Tract 314"
060750314003,404,380,24,70,160,0.0594059405940594,0.18421052631578946,0.42105263157894735,"Block Group 3,  Census Tract 314"
060750310002,415,408,7,262,57,0.016867469879518072,0.6421568627450981,0.13970588235294118,"Block Group 2,  Census Tract 310"
060750135001,849,756,93,612,598,0.10954063604240283,0.8095238095238095,0.791005291005291,"Block Group 1,  Census Tract 135"
060750330005,455,430,25,190,160,0.054945054945054944,0.4418604651162791,0.37209302325581395,"Block Group 5,  Census Tract 330"
060750426012,1063,970,93,597,670,0.08748824082784572,0.6154639175257732,0.6907216494845361,"Block Group 2,  Census Tract 426.01"
060750607002,176,165,11,105,150,0.0625,0.6363636363636364,0.9090909090909091,"Block Group 2,  Census Tract 607"
060750121002,626,572,54,305,550,0.08626198083067092,0.5332167832167832,0.9615384615384616,"Block Group 2,  Census Tract 121"
060750133002,566,508,58,455,280,0.10247349823321555,0.8956692913385826,0.5511811023622047,"Block Group 2,  Census Tract 133"
060750158013,686,645,41,329,559,0.0597667638483965,0.5100775193798449,0.8666666666666667,"Block Group 3,  Census Tract 158.01"
060750168022,648,619,29,382,529,0.044753086419753084,0.617124394184168,0.8546042003231018,"Block Group 2,  Census Tract 168.02"
060750207001,1285,1215,70,892,962,0.054474708171206226,0.7341563786008231,0.7917695473251029,"Block Group 1,  Census Tract 207"
060750228021,257,238,19,152,178,0.07392996108949416,0.6386554621848739,0.7478991596638656,"Block Group 1,  Census Tract 228.02"
060750232002,446,409,37,39,197,0.08295964125560538,0.09535452322738386,0.48166259168704156,"Block Group 2,  Census Tract 232"
060750262004,399,373,26,72,153,0.06516290726817042,0.19302949061662197,0.4101876675603217,"Block Group 4,  Census Tract 262"
060750308005,636,610,26,356,176,0.040880503144654086,0.5836065573770491,0.28852459016393445,"Block Group 5,  Census Tract 308"
